30
30
PPPPPPPPPPPPPPPPPPPPPPPPPPPPPP
PPPPPPPPPPPPPPPPPPPPPPPPPPPPPP
PPPPPPPPPPPPPPPPPPPPPPPPPPPPPP
PPPTSTTTTTTTTTAABSSSSAAAASSPPP
PPPSSTTTTTTTTAABBBSSAAAASSBPPP
PPPSTTTTTTTTTAABBBBSSAASSBBPPP
PPPTTTTTTTTTTTAABBBSSASSBBBPPP
PPPTTTTTTTTTKTAABBSSAASSBBBPPP
PPPTKTTTTTTTTTAABBBSSASSBTKPPP
PPPTTTTTTTTTTAABBBSSSSSSBTTPPP
PPPTTTTKTTTTTAABBBKSSSSBBBBPPP
PPPTTTTTTTTTTAABBBSSBBSSBBBPPP
PPPTTTTTTTTTTAABBSSSSBSSBBBPPP
PPPTTTTTTTTTTTAABSSSSSSBBBSPPP
PPPTTTTTTTTTTTAABSSBSSBBBSSPPP
PPPTTTTTTTTTTTBAASSSSBSBSSBPPP
PPPTTSTSSSSSSSSSBSSBSSSSSBBPPP
PPPSSSSSMMMMMMMSSSBSSSBSBBBPPP
PPPSSASSSSSSSSMSSBSSBBBBBBBPPP
PPPAAAASMSSSSSMSSSSSSBBBBBBPPP
PPPAAAASMSSSSSSSBSSSSSBBBBBPPP
PPPAAAASMSSSSSMSBBSSTSSBBBBPPP
PPPAAAASMSSSSSMSBSSTTSSBBBBPPP
PPPAAAASMMMMMMMSBBSSTKSSBBBPPP
PPPSSAASSSSSSSSSBBBSSTTSSBBPPP
PPPSSSSSTKBBBBBSSKBBSSSTSBBPPP
PPPSTSSSTTBBBBSSBBBBBBSSBBBPPP
PPPPPPPPPPPPPPPPPPPPPPPPPPPPPP
PPPPPPPPPPPPPPPPPPPPPPPPPPPPPP
PPPPPPPPPPPPPPPPPPPPPPPPPPPPPP
